SSSSSSSSSSSSSSSSSSSS
SSSSSSSSSSSSSSSSSSSS
SSSSIIIIIIISSSSSSSSS
SSSSIIIIIIISSSSSSSSS
SSSSIIIIIISSSSCLLLSS
SSSSSSSSSSSSSSCLLLSS
SSSSCCCCCCCCSSCLLFSS
SSSSLLLLLLLLSSCLLFSS
SSSSSSSSSSSSSSSSSSSS
SSSSSSSSSSSSSSSSSSSS
SSSSSSSSLLLLLLLLLLLS
SSSSSSSSFFFFFFFFFFLS
SSSSSSSSCCCCCFFFFFLS
SSSSSSSSCCCCCCCCCCLS
SSLLLLCSLLLLLLLLLLLS
SSLFFFCSSSSSSSSSSSSS
SSFFFFCSSSSSSSSSSSSS
SSFFFFFFCCCCCSSSSSSS
SSCCCCCCCCCCCSSSSSSS
SSSSSSSSSSSSSSSSSSSS
